



R     800 600


SO ./van1.xpm
WE ./redbrick.xpm
NO ./greystone.xpm


EA ./bluestone.xpm



F 180,   110,     150
S ./barrel.xpm

C 135, 206,195

1111111111111111111111111111111111
   111111111E111111111111111111
111111100000000000000001
100000000000000111111111
1000000100000000001
10000000020000011111
100000000020000001
100000000000000011111
1000000000200000011
1000000000200000001
1000020000000000001
1000000000200000001
1000000000000000001
11111111111111111111
