


SO ./bereza.xpm
WE ./palms.xpm
NO ./hvojnye.xpm
R 900 700
EA ./mounts.xpm



F 195,  150, 75
C 50,106,180
S ./pillar.xpm






11111111111111111111111111111111111
1111111000000011111111111111111111
111111100002000000000000000000000N1
10000000000000011111111100000200001
10000001000000000011111100200000011
10000000020000011111111100000000011
10000000002000000111111100011111111
10000000000000000111111102011111111
10000000002000000111111100011111111
10000000002000000000000000011111111
1000020000000000002000000011111111
10000000002000000011111111111111111
10000000000000000011111111111111111
11111110000000111111111111111111111
11111110000200000000000000000000011
10000000000000011111111100000200011
10000001000000000011111100200000011
10000000020000011111111100000000011
10000000002000000111111100011111111
10000000000000000111111102011111111
10000000002000000111111100011111111
10000000002000000000000000011111111
10000200000000000002000000011111111
10000000002000010011111111111111111
10000000000000000011111111111111111
11111110000000111111111111111111111
11111110000200000000000000000000001
10000000000000011111111100000200011
10000001000000000011111100200000011
10000000020000011111111100000000011
10000000002000000111111100011111111
10000000000000000111111102011111111
10000000002000000111111100011111111
10000000002000000000000000011111111
10000200000000000002000000011111111
10000000002000000011111111111111111
10000000000000000011111111111111111
11111110000000111111111111111111111
11111110000200000000000000000000011
10000000000000011111111100000200011
10000001000000000011111100200000011
10000000020000011111111100000000011
10000000002000000111111100011111111
10000000000000000111111102011111111
10000000002000000111111100011111111
10000000002000000000000000011111111
10000200000000000002000000011111111
10000000002000010011111111111111111
10000000000000000011111111111111111
11111111111111111111111111111111111








